WWWWWWWWWWWWWWWWWWWWWWWWWWWWWW
W............................W
W..WWWWWWWWWWWWWWWWWWWWWW..W.W
W..W....................W..W.W
W..W..P.................W..W.W
W..W....................W..W.W
W..WWWWWWWWWWWWWW..WWWWWW..W.W
W..................W.......W.W
WWWWWWWWWWWWWWWWWWWWWWWWWWWWWW